NO maps/wall.xpm
WE maps/wall.xpm
F 64,0,32
SO maps/wall.xpm



EA maps/wall.xpm

C 255,255,255

11111
10001   
10001 
1000011111
11100000001
  1001111011
  100100101
  100100101N
  100111101
  100000001
  100000001
  11111111