NO textures/wall3.xpm
SO textures/wall3.xpm
EA textures/wall3.xpm
WE textures/wall3.xpm

F 33,33,33
C 144,141,142

1111111   1111111
1000001   1000001
10000011111000001
100E0000000000001
10000011111000001
1000001   1000001
1111111   1111111