NO textures/wall4.xpm
SO textures/wall4.xpm
WE textures/wall4.xpm
EA textures/wall4.xpm

F 59,59,59
C 82,82,82

11111
10001
10001
10000111111
11100000001
  100010001
  100000001
  111111111

  111111111
  100000001
  100010001
  100010001
  100N10001
  100000001
  111111111