NO maps/wall.xpm
WE maps/wall.xpm
F 64,0,32
SO maps/wall.xpm

EA maps/wall.xpm

C 255,255,255

11111 
10001   
10001 
1000011111 
11100000001
  101010101
  100000001
  111111111

  111111111
  100000001
1 10101Y101
  100000001
  101N10101
  100000001
  11111111 