NO textures/wall5.xpm
SO textures/wall5.xpm
WE textures/wall5.xpm
EA textures/wall5.xpm

F 59,59,59
C 82,82,82

1111111111111111111
1000000000000000001
1000000000000000001
1000000000000000001
1000000000000000001
1000001111111000001
1000001     1000001
1000001     1000001
1000001     1000001
1000001     1000001
1000001     1000001
1000001     1000001
1000001111111000001
1000000000000000001
1000000000000000001
1000000000000000001
100000000N000000001
1000000000000000001
1111111111111111111