NO textures/wall6.xpm
SO textures/wall6.xpm
WE textures/wall6.xpm
EA textures/wall6.xpm

F 59,59,59
C 82,82,82

1111111111111111111
1000000100000S00001
1011100100000000001
1000000100111111001
1001000000100000001
1001001111111001111
1001001     1000001
1000001     1001001
1000001     1001001
1001111     1001001
1000001     1001001
1111001     1000001
1001001111111000001
1001000001001111001
1000001000000000001
1000001001000001001
1001111001011111001
1000000001000000001
1111111111111111111